5,0,5,0,5,
0,5,0,5,0,
2,0,3,0,5,
2,5,0,5,2,
2,5,2,5,2,