4,0,4,0,4,
0,4,0,4,0,
4,0,3,0,4,
0,4,0,4,0,
4,0,4,0,4,















