2,0,5,0,2
0,4,0,4,0
5,0,3,0,5
0,4,0,4,0
2,0,5,0,2
