5,5,5,5,0
2,5,5,0,0
0,4,3,0,0
0,0,5,2,0
0,5,5,5,2